10 10
. . . 11 . . . . . .
. X . . . . . . X .
. . 3 . . X . X . .
1 . 2 . . 1 . . . .
. . X 3 . . . 9 . .
X 4 . . 3 . . . . .
. . . . X . X . . 12
. . X . . 4 . 3 . .
. 3 . . 6 . . X . 2
87 X X X . . 2 . 1 .

