19 13
. . 2 . . . X . . . . . 1 . . 4 . X .
. X . . . . . . . 2 . . . . . . . 5 .
. . . 1 . . . X . . . . . 3 . . . . .
. X . X X 1 . . . . X . . . X 3 2 . .
. . . . . 3 . . . X . . . . . . 17 . .
. . 3 . . . . 4 . . . . 4 . . . . 12 .
. . . . 4 . . . . . . . 5 . . . X . .
. . . X . . 2 . 4 . . . 2 X . . . . .
. X . . . . . . 2 . 6 . . . . . . 3 .
. . . . 1 3 . 11 . X X . . . 4 . . . .
2 . . . . X . . . . . . 3 . . . . . .
. . 3 . . . . 2 . . . 7 . . . . 5 17 .
. . . X . . . . . . . . . . X . . . .
. X . X . . 5 . . . . . . X 12 . . X .
. . 3 . . . . . . X . . . . X 1 . X .
. . . . X X X X 6 . . . 9 . . . . . .
. X . . . . . . . . . . . X . 11 . 2 .
. . 4 . . . . X . . . . . . . . X . .
. . . . 9 . . 13 25 . X . . 2 . . . 4 .