28 27
.X..X.........X........
......X................
.................X.....
X...........X....X.....
.XX........X.X...X.....
.......X.......X.X.....
...X......X......Xx....
X.X........XX..X.......
.......................
...X..X.........X......
X..X......X......X..X.X
XXXX...........X.....X1
