6 6
. . 1 1 5 3
. . 1 1 5 3
. . 1 1 4 3
. . 1 1 6 2
. . 1 1 4 2
. . 1 1 4 8