25 8
. X . 13 . . 2 .
. . X . . . . .
. 2 . . . . X X
X . 1 . X . X 3
. . . 4 . 5 . .
. 3 X . . . . .
. . 2 . . X . .
. X . . 4 . . 2
. 3 . . . . X .
. . . X X . . .
. . 13 . . . 17 .
. X . . . X . .
111 . . X . . 2 .
. . X 3 . . . X
. 2 . . . 3 . .
. X 4 . X . 9 .
7 . X . 8 X . .
. 6 . X . . . X
. 1 . X . 5 . .
. . 3 . . . 6 .
. X . 7 . . . .
. . . . . X . .
. 3 . X . 6 . 9
. . 4 X . 5 . .
. 3 . . 2 3 . X